F 76,76,76
C 99,99,99

NO ./assets/base/eagle.xpm
SO ./assets/base/greystone.xpm
WE ./assets/base/purplestone.xpm
EA ./assets/base/red.xpm

1111111111111111111
10N1001001001000001
1011000001000201001
1001001001111101111
1001111002001001001
1002000002000001001
1001111111111001001
1111000002000001011
1002000001000000001
1111111111111111111
