







NO ./assets/test.xpm








SO ./assets/test.xpm
                        WE ./assets/test.xpm
        EA ./assets/test.xpm

        F 20,           20,             20
C 200,          200,200

1111111111111111111
1001001001001000001
1011000001000001001
1001001001111101111
10W1111000001001001
1000000000000001001
1001111111111001001
1111000000000001011
1000000001000000001
1111111111111111111






















