







NO ./assets/test.xpm








SO ./assets/test.xpm
                        WE ./assets/test.xpm
        EA ./assets/test.xpm

        F 20,           20,             20
C 200,          200,200

01111
10001
10S01
10001
10001
10001
11001
10001
10001
10001
10001
10001
11111






















